11111
10001
10EC1
11111
11111
11111