1111111111111111111111111111111111111
10000100000001C0000000000000000000001
1000E10000000100000000000000000000001
1001110000000100000000001100000000001
100000000000000000000000C100000000001
1000C0000000C000000000000000000000001
1000000000000000000000000000000111101
1000001110000000000000000000000100001
1000001P1000000000000000000000010C101
100000101000000000000000000000010C101
100000C010000000000000000000000100001
1111111111111111111111111111111111111