11111111
10C101C1
10110001
10E00111
10000001
11100C11
1P000001
11111111