11111111
10C1E1C1
10110001
10000111
10000001
11100C11
1P000001
11111111