11111111
10C101C1
1E110001
10000111
10000001
11100C11
1P000001
11111111