1111111111111111111111111111111111111111
111111111111P01111111111CE11111111111111
1111111111110011111111110011111111111111
111111111111C011111111110C11111111111111
1111111111110011111111110011111111111111
1111111111110011111111110011111111111111
1111111111110011111111110011111111111111
1111111111110011111111110C11111111111111
1111111111110C11111111110011111111111111
1110C11111110011111111110011111111111111
111001111111001111111111C011111111111111
1110011111110C11111111110011111111111111
1110000000000000000000000000000000000111
111C00000000C00000000000C00000000000C111
1111111111111111111111111111111111111111